I00 I00 I00 I00 I00 I00 I00 I00 I00 I00 I00 I00 I00 I00 I00 I00 I00 I00 I00 I00 I00 I00 I00 I00 I00 I00 I00 I00 I00 I00 I00 I00 I00 I00 I00 I00 I00 I00 I00 I00 I00 I00 I00 I00 I00 I00 I00 I00 I00 I00 I00 I00 I00 I00 I00 I00 I00 I00 I00 I00 I00 I00 I00 I00 I00 I00 I00 I00 I00 I00 I00 I00 I00 I00 I00 I00 I00 I00 I00 I00 I00 I00 I00 I00 I00 I00 I00 I00 I00 I00 I00 I00 I00 I00 I00 I00 I00 I00 I00 I00 I00 I00 I00 I00 I00 I00 I00 I00 I00 I00 I00 I00 I00 I00 I00 I00 I00 I00 I00 I00 I00 I00 I00 I00 I00
I00 I00 I00 I00 I00 I00 I00 I00 I00 I00 I00 I00 I00 I00 I00 I00 I00 I00 I00 I00 I00 I00 I00 I00 I00 I00 I00 I00 I00 I00 I00 I00 I00 I00 I00 I00 I00 I00 I00 I00 I00 I00 I00 I00 I00 I00 I00 I00 I00 I00 I00 I00 I00 I00 I00 I00 I00 I00 I00 I00 I00 I00 I00 I00 I00 I00 I00 I00 I00 I00 I00 I00 I00 I00 I00 I00 I00 I00 I00 I00 I00 I00 I00 I00 I00 I00 I00 I00 I00 I00 I00 I00 I00 I00 I00 I00 I00 I00 I00 I00 I00 I00 I00 I00 I00 I00 I00 I00 I00 I00 I00 I00 I00 I00 I00 I00 I00 I00 I00 I00 I00 I00 I00 I00 I00
I00 I00 I00 I00 I00 I00 I00 I00 I00 I00 I00 I00 I00 I00 I00 I00 I00 I00 I00 I00 I00 I00 I00 I00 I00 I00 I00 I00 I00 I00 I00 I00 I00 I00 I00 I00 I00 I00 I00 I00 I00 I00 I00 I00 I00 I00 I00 I00 I00 I00 I00 I00 I00 I00 I00 I00 I00 I00 I00 I00 I00 I00 I00 I00 I00 I00 I00 I00 I00 I00 I00 I00 I00 I00 I00 I00 I00 I00 I00 I00 I00 I00 I00 I00 I00 I00 I00 I00 I00 I00 I00 I00 I00 I00 I00 I00 I00 I00 I00 I00 I00 I00 I00 I00 I00 I00 I00 I00 I00 I00 I00 I00 I00 I00 I00 I00 I00 I00 I00 I00 I00 I00 I00 I00 I00
I00 I00 I00 I00 I00 I00 I00 I00 I00 I00 I00 I00 I00 I00 I00 I00 I00 I00 I00 I00 I00 I00 I00 I00 I00 I00 I00 I00 I00 I00 I00 I00 I00 I00 I00 I00 I00 I00 I00 I00 I00 I00 I00 I00 I00 I00 I00 I00 I00 I00 I00 I00 I00 I00 I00 I00 I00 I00 I00 I00 I00 I00 I00 I00 I00 I00 I00 I00 I00 I00 I00 I00 I00 I00 I00 I00 I00 I00 I00 I00 I00 I00 I00 I00 I00 I00 I00 I00 I00 I00 I00 I00 I00 I00 I00 I00 I00 I00 I00 I00 I00 I00 I00 I00 I00 I00 I00 I00 I00 I00 I00 I00 I00 I00 I00 I00 I00 I00 I00 I00 I00 I00 I00 I00 I00
I00 I00 I00 I00 I00 I00 I00 I00 I00 I00 I00 I00 I00 I00 I00 I00 I00 I00 I00 I00 I00 I00 I00 I00 I00 I00 I00 I00 I00 I00 I00 I00 I00 I00 I00 I00 I00 I00 I00 I00 I00 I00 I00 I00 I00 I00 I00 I00 I00 I00 I00 I00 I00 I00 I00 I00 I00 I00 I00 I00 I00 I00 I00 I00 I00 I00 I00 I00 I00 I00 I00 I00 I00 I00 I00 I00 I00 I00 I00 I00 I00 I00 I00 I00 I00 I00 I00 I00 I00 I00 I00 I00 I00 I00 I00 I00 I00 I00 I00 I00 I00 I00 I00 I00 I00 I00 I00 I00 I00 I00 I00 I00 I00 I00 I00 I00 I00 I00 I00 I00 I00 I00 I00 I00 I00
I00 I00 I00 I00 I00 I00 I00 I00 I00 I00 I00 I00 I00 I00 I00 I00 I00 I00 I00 I00 I00 I00 I00 I00 I00 I00 I00 I00 I00 I00 I00 I00 I00 I00 I00 I00 I00 I00 I00 I00 I00 I00 I00 I00 I00 I00 I00 I00 I00 I00 I00 I00 I00 I00 I00 I00 I00 I00 I00 I00 I00 I00 I00 I00 I00 I00 I00 I00 I00 I00 I00 I00 I00 I00 I00 I00 I00 I00 I00 I00 I00 I00 I00 I00 I00 I00 I00 I00 I00 I00 I00 I00 I00 I00 I00 I00 I00 I00 I00 I00 I00 I00 I00 I00 I00 I00 I00 I00 I00 I00 I00 I00 I00 I00 I00 I00 I00 I00 I00 I00 I00 I00 I00 I00 I00
I00 I00 I00 I00 I00 I00 I00 I00 I00 I00 I00 I00 I00 I00 I00 I00 I00 I00 I00 I00 I00 I00 I00 I00 I00 I00 I00 I00 I00 I00 I00 I00 I00 I00 I00 I00 I00 I00 I00 I00 I00 I00 I00 I00 I00 I00 I00 I00 I00 I00 I00 I00 I00 I00 I00 I00 I00 I00 I00 I00 I00 I00 I00 I00 I00 I00 I00 I00 I00 I00 I00 I00 I00 I00 I00 I00 I00 I00 I00 I00 I00 I00 I00 I00 I00 I00 I00 I00 I00 I00 I00 I00 I00 I00 I00 I00 I00 I00 I00 I00 I00 I00 I00 I00 I00 I00 I00 I00 I00 I00 I00 I00 I00 I00 I00 I00 I00 I00 I00 I00 I00 I00 I00 I00 I00
I00 I00 I00 I00 I00 I00 I00 I00 I00 I00 I00 I00 I00 I00 I00 I00 I00 I00 I00 I00 I00 I00 I00 I00 I00 I00 I00 I00 I00 I00 I00 I00 I00 I00 I00 I00 I00 I00 I00 I00 I00 I00 I00 I00 I00 I00 I00 I00 I00 I00 I00 I00 I00 I00 I00 I00 I00 I00 I00 I00 I00 I00 I00 I00 I00 I00 I00 I00 I00 I00 I00 I00 I00 I00 I00 I00 I00 I00 I00 I00 I00 I00 I00 I00 I00 I00 I00 I00 I00 I00 I00 I00 I00 I00 I00 I00 I00 I00 I00 I00 I00 I00 I00 I00 I00 I00 I00 I00 I00 I00 I00 I00 I00 I00 I00 I00 I00 I00 I00 I00 I00 I00 I00 I00 I00
I00 I00 I00 I00 I00 I00 I00 I00 I00 I00 I00 I00 I00 I00 I00 I00 I00 I00 I00 I00 I00 I00 I00 I00 I00 I00 I00 I00 I00 I00 I00 I00 I00 I00 I00 I00 I00 I00 I00 I00 I00 I00 I00 I00 I00 I00 I00 I00 I00 I00 I00 I00 I00 I00 I00 I00 I00 I00 I00 I00 I00 I00 I00 I00 I00 I00 I00 I00 I00 I00 I00 I00 I00 I00 I00 I00 I00 I00 I00 I00 I00 I00 I00 I00 I00 I00 I00 I00 I00 I00 I00 I00 I00 I00 I00 I00 I00 I00 I00 I00 I00 I00 I00 I00 I00 I00 I00 I00 I00 I00 I00 I00 I00 I00 I00 I00 I00 I00 I00 I00 I00 I00 I00 I00 I00
I00 I00 I00 I00 I00 I00 I00 I00 I00 I00 I00 I00 I00 I00 I00 I00 I00 I00 I00 I00 I00 I00 I00 I00 I00 I00 I00 I00 I00 I00 I00 I00 I00 I00 I00 I00 I00 I00 I00 I00 I00 I00 I00 I00 I00 I00 I00 I00 I00 I00 I00 I00 I00 I00 I00 I00 I00 I00 I00 I00 I00 I00 I00 I00 I00 I00 I00 I00 I00 I00 I00 I00 I00 I00 I00 I00 I00 I00 I00 I00 I00 I00 I00 I00 I00 I00 I00 I00 I00 I00 I00 I00 I00 I00 I00 I00 I00 I00 I00 I00 I00 I00 I00 I00 I00 I00 I00 I00 I00 I00 I00 I00 I00 I00 I00 I00 I00 I00 I00 I00 I00 I00 I00 I00 I00
I00 I00 I00 I00 I00 I00 I00 I00 I00 I00 I00 I00 I00 I00 I00 I00 I00 I00 I00 I00 I00 I00 I00 I00 I00 I00 I00 I00 I00 I00 I00 I00 I00 I00 I00 I00 I00 I00 I00 I00 I00 I00 I00 I00 I00 I00 I00 I00 I00 I00 I00 I00 I00 I00 I00 I00 I00 I00 I00 I00 I00 I00 I00 I00 I00 I00 I00 I00 I00 I00 I00 I00 I00 I00 I00 I00 I00 I00 I00 I00 I00 I00 I00 I00 I00 I00 I00 I00 I00 I00 I00 I00 I00 I00 I00 I00 I00 I00 I00 I00 I00 I00 I00 I00 I00 I00 I00 I00 I00 I00 I00 I00 I00 I00 I00 I00 I00 I00 I00 I00 I00 I00 I00 I00 I00
I00 I00 I00 I00 I00 I00 I00 I00 I00 I00 I00 I00 I00 I00 I00 I00 I00 I00 I00 I00 I00 I00 I00 I00 I00 I00 I00 I00 I00 I00 I00 I00 I00 I00 I00 I00 I00 I00 I00 I00 I00 I00 I00 I00 I00 I00 I00 I00 I00 I00 I00 I00 I00 I00 I00 I00 I00 I00 I00 I00 I00 I00 I00 I00 I00 I00 I00 I00 I00 I00 I00 I00 I00 I00 I00 I00 I00 I05 I00 I00 I00 I00 I00 I00 I00 I00 I00 I00 I00 I00 I00 I00 I00 I00 I00 I00 I00 I00 I00 I00 I00 I00 I00 I00 I00 I00 I00 I00 I00 I00 I00 I00 I00 I00 I00 I00 I00 I00 I00 I00 I00 I00 I00 I00 I00
I00 I00 I00 I00 I00 I00 I00 I00 I00 I00 I00 I00 I00 I00 I00 I00 I00 I00 I01 I00 I00 I00 I00 I00 I00 I00 I00 I00 I00 I00 I01 I00 I00 I00 I00 I00 I00 I00 I00 I06 I00 I00 I00 I00 I00 I00 I00 I00 I00 I00 I00 I00 I00 I00 I00 I00 I00 I00 I00 I00 I00 I00 I00 I00 I00 I00 I00 I00 I00 I00 I00 I00 I00 I00 I00 I00 I01 I00 I01 I00 I00 I00 I00 I00 I00 I00 I00 I00 I00 I00 I00 I01 I00 I00 I00 I00 I00 I00 I00 I00 I00 I00 I00 I00 I00 I00 I00 I00 I00 I00 I00 I00 I00 I00 I00 I00 I00 I00 I00 I00 I00 I00 I00 I00 I00
I00 I00 I00 I00 I00 I00 I00 I00 I00 I00 I00 I00 I00 I00 I00 I00 I00 I01 I00 I01 I00 I00 I00 I00 I00 I00 I00 I00 I00 I00 I00 I00 I00 I00 I00 I00 I00 I00 I00 I00 I00 I00 I00 I00 I00 I00 I00 I00 I00 I00 I00 I00 I00 I00 I00 I00 I00 I00 I00 I00 I00 I00 I00 I00 I00 I00 I01 I00 I00 I00 I00 I00 I00 I00 I00 I01 I00 I00 I00 I01 I00 I00 I00 I00 I00 I00 I00 I00 I00 I00 I00 I00 I00 I00 I00 I00 I00 I00 I00 I00 I00 I00 I00 I00 I00 I00 I00 I00 I00 I00 I00 I00 I00 I00 I00 I00 I00 I00 I00 I00 I00 I00 I00 I00 I00
I00 I00 I00 I00 I00 I00 I00 I00 I00 I00 I00 I00 I00 I00 I00 I00 I01 I00 I00 I00 I01 I00 I00 I00 I00 I00 I00 I00 I01 I00 I00 I00 I01 I00 I00 I00 I00 I00 I00 I00 I00 I00 I00 I00 I00 I00 I00 I00 I00 I00 I00 I00 I00 I00 I00 I00 I00 I00 I00 I00 I00 I00 I00 I00 I00 I01 I01 I01 I00 I00 I00 I00 I00 I00 I01 I00 I00 I00 I00 I00 I01 I00 I00 I00 I00 I00 I00 I00 I00 I00 I00 I00 I00 I00 I00 I00 I00 I00 I00 I00 I06 I00 I00 I00 I00 I00 I00 I00 I00 I00 I00 I00 I00 I00 I00 I00 I00 I00 I00 I00 I00 I00 I00 I00 I00
I00 I00 I00 I00 I00 I00 I00 I00 I00 I00 I00 I00 I00 I00 I00 I01 I00 I00 I00 I00 I00 I01 I00 I00 I00 I00 I00 I00 I00 I00 I00 I00 I00 I00 I00 I00 I00 I00 I00 I00 I00 I00 I00 I00 I00 I00 I00 I00 I00 I00 I00 I00 I00 I00 I00 I00 I00 I00 I00 I00 I00 I00 I00 I00 I01 I01 I01 I01 I01 I00 I00 I00 I00 I01 I00 I00 I00 I00 I00 I00 I00 I01 I00 I00 I00 I00 I00 I00 I00 I00 I00 I00 I00 I00 I00 I00 I00 I00 I00 I00 I00 I00 I00 I00 I00 I00 I00 I00 I00 I00 I06 I00 I00 I00 I00 I00 I00 I00 I00 I00 I00 I00 I00 I00 I00
I00 I00 I00 I00 I00 I00 I00 I00 I00 I00 I00 I00 I00 I00 I00 I00 I00 I00 I00 I00 I00 I00 I00 I00 I00 I00 I00 I00 I00 I00 I00 I00 I00 I00 I00 I00 I00 I00 I00 I00 I00 I00 I00 I00 I00 I00 I00 I00 I00 I00 I00 I00 I00 I00 I00 I00 I00 I00 I00 I00 I00 I00 I00 I00 I00 I00 I00 I00 I00 I00 I00 I00 I00 I00 I00 I00 I00 I00 I00 I00 I00 I00 I00 I00 I00 I00 I00 I00 I00 I00 I00 I00 I00 I00 I00 I00 I00 I00 I00 I00 I00 I00 I00 I00 I00 I00 I00 I00 I00 I00 I00 I00 I00 I00 I00 I00 I00 I00 I00 I00 I00 I00 I00 I00 I00
I00 I00 I00 I00 I00 I00 I00 I00 I00 I00 I00 I00 I00 I00 I00 I00 I00 I00 I00 I00 I00 I00 I00 I00 I00 I00 I00 I00 I00 I00 I00 I00 I00 I00 I00 I00 I00 I00 I00 I00 I00 I00 I00 I00 I00 I00 I00 I00 I00 I00 I00 I00 I00 I00 I00 I00 I00 I00 I00 I00 I00 I00 I00 I00 I00 I00 I00 I00 I00 I00 I00 I00 I00 I00 I00 I00 I00 I00 I00 I00 I00 I00 I00 I00 I00 I00 I00 I00 I00 I00 I00 I00 I00 I00 I00 I00 I00 I00 I00 I00 I00 I00 I00 I00 I00 I00 I00 I00 I00 I00 I00 I00 I00 I00 I00 I00 I00 I00 I00 I00 I00 I00 I00 I00 I00
