I00 I00 I00 I00 I00 I00 I00 I00 I00 I00 I00 I00 I00 I00 I00 I00 I00 I00 I00 I00 I00 I00 I00 I00 I00 I00 I00 I00 I00 I00 I00 I00 I00 I00 I00 I00 I00 I00 I00 I00 I00 I00 I00 I00 I00 I00 I00 I00 I00 I00 I00 I00 I00 I00 I00 I00 I00 I00 I00 I00 I00 I00 I00 I00 I00 I00 I00 I00 I00 I00 I00 I00 I00 I00 I00 I00 I00 I00 I00 I00 I00 I00 I00 I00 I00 I00 I00 I00 I00 I00 I00 I00 I00 I00 I00 I00 I00 I00 I00 I00 I00 I00 I00 I00 I00 I00 I00 I00 I00 I00 I00 I00 I00 T02 T03 T04 I00 I00 T02 T03 T04 I00 I00 T02 T03
I00 I00 I00 I00 I00 I00 I00 I00 I00 I00 I00 I00 I00 I00 I00 I00 I00 I00 I00 I00 I00 I00 I00 I00 I00 I00 I00 I00 I00 I00 I00 I00 I00 I00 I00 I00 I00 I00 I00 I00 I00 I00 I00 I00 I00 I00 I00 I00 I00 I00 I00 I00 I00 I00 I00 I00 I00 I00 I00 I00 I00 I00 I00 I00 I00 I00 I00 I00 I00 I00 I00 I00 I00 I00 I00 I00 I00 I00 I00 I00 I00 I00 I00 I00 I00 I00 I00 I00 I00 I00 I00 I00 I00 I00 I00 I00 I00 I00 I00 I00 I00 I00 I00 I00 I00 I00 I00 I00 I00 I00 I00 I00 I00 T02 T03 T04 I00 I00 T02 T03 T04 I00 I00 T02 T03
I00 I00 I00 I00 I00 I00 I00 I00 I00 I00 I00 I00 I00 I00 I00 I00 I00 I00 I00 I00 I00 I00 I00 I00 I00 I00 I00 I00 I00 I00 I00 I00 I00 I00 I00 I00 I00 I00 I00 I00 I00 I00 I00 I00 I00 I00 I00 I00 I00 I00 I00 I00 I00 I00 I00 I00 I00 I00 I00 I00 I00 I00 I00 I00 I00 I00 I00 I00 I00 I00 I00 I00 I00 I00 I00 I00 I00 I00 I00 I00 I00 I00 I00 I00 I00 I00 I00 I00 I00 I00 I00 I00 I00 I00 I00 I00 I00 I00 I00 I00 I00 I00 I00 I00 I00 I00 I00 I00 I00 I00 I00 I00 I00 T02 T03 T04 I00 I00 T02 T03 T04 I00 I00 T02 T03
I00 I00 I00 I00 I00 I00 I00 I00 I00 I00 I00 I00 I00 I00 I00 I00 I00 I00 I00 I00 I00 I00 I00 I00 I00 I00 I00 I00 I00 I00 I00 I00 I00 I00 I00 I00 I00 I00 I00 I00 I00 I00 I00 I00 I00 I00 I00 I00 I00 I00 I00 I00 I00 I00 I00 I00 I00 I00 I00 I00 I00 I00 I00 I00 I00 I00 I00 I00 I00 I00 I00 I00 I00 I00 I00 I00 I00 I00 I00 I00 I00 I00 I00 I00 I00 I00 I00 I00 I00 I00 I00 I00 I00 I00 I00 I00 I00 I00 I00 I00 I00 I00 I00 I00 I00 I00 I00 I00 I00 I00 I00 I00 I00 T02 T03 T04 I00 I00 T02 T03 T04 I00 I00 T02 T03
I00 I00 I00 I00 I00 I00 I00 I00 I00 I00 I00 I00 I00 I00 I00 I00 I00 I00 I00 I00 I00 I00 I00 I00 I00 I00 I00 I00 I00 I00 I00 I00 I00 I00 I00 I00 I00 I00 I00 I00 I00 I00 I00 I00 I00 I00 I00 I00 I00 I00 I00 I00 I00 I00 I00 I00 I00 I00 I00 I00 I00 I00 I00 I00 I00 I00 I00 I00 I00 I00 I00 I00 I00 I00 I00 I00 I00 I00 I00 I00 I00 I00 I00 I00 I00 I00 I00 I00 I00 I00 I00 I00 I00 I00 I00 I00 I00 I00 I00 I00 I00 I00 I00 I00 I00 I00 I00 I00 I00 I00 I00 I00 I00 T02 T03 T04 I00 I00 T02 T03 T04 I00 I00 T02 T03
I00 I00 I00 I00 I00 I00 I00 I00 I00 I00 I00 I00 I00 I00 I00 I00 I00 I00 I00 I00 I00 I00 I00 I00 I00 I00 I00 I00 I00 I00 I00 I00 I00 I00 I00 I00 I00 I00 I00 I00 I00 I00 I00 I00 I00 I00 I00 I00 I00 I00 I00 I00 I00 I00 I00 I00 I00 I00 I00 I00 I00 I00 I00 I00 I00 I00 I00 I00 I00 I00 I00 I00 I00 I00 I00 I00 I00 I00 I00 I00 I00 I00 I00 I00 I00 I00 I00 I00 I00 I00 I00 I00 I00 I00 I00 I00 I00 I00 I00 I00 I00 I00 I00 I00 I00 I00 I00 I00 I00 I00 I00 I00 I00 T02 T03 T04 I00 I00 T02 T03 T04 I00 I00 T02 T03
0T2 I00 I00 I00 I00 I00 I00 I00 I00 I00 I00 I00 I00 I00 I00 I00 I00 I00 I00 I00 I00 I00 I00 I00 I00 I00 I00 I00 I00 I00 I00 I00 I00 I00 I00 I00 I00 I00 I00 I00 I00 I00 I00 I00 I00 I00 I00 I00 I00 I00 I00 I00 I00 I00 I00 I00 I00 I00 I00 I00 I00 I00 I00 I00 I00 I00 I00 I00 I00 I00 I00 I00 I00 I00 I00 I00 I00 I00 I00 I00 I00 I00 I00 I00 I00 I00 I00 I00 I00 I00 I00 I00 I00 I00 I00 I00 I00 I00 I00 I00 I00 I00 I00 I00 I00 I00 I00 I00 I00 I00 I00 I00 I00 T02 T03 T04 I00 I00 T02 T03 T04 I00 I00 T02 T03
0T1 I00 I00 I00 I00 I00 I00 I00 I00 I00 I00 I00 I00 I00 I00 I00 I00 I00 I00 I00 I00 I00 I00 I00 I00 I00 I00 I00 I00 I00 I00 I00 I00 I00 I00 I00 I00 I00 I00 I00 I00 I00 I00 I00 I00 I00 I00 I00 I00 I00 I00 I00 I00 I00 I00 I00 I00 I00 I00 I00 I00 I00 I00 I00 I00 I00 I00 I00 I00 I00 I00 I00 I00 I00 I00 I00 I00 I00 I00 I00 I00 I00 I00 I00 I00 I00 I00 I00 I00 I00 I00 I00 I00 I00 I00 I00 I00 I00 I00 I00 I00 I00 I00 I00 I00 I00 I00 I00 I00 I00 I00 I00 I00 T02 T03 T04 I00 I00 T02 T03 T04 I00 I00 T02 T03
00B 00A 00B 00A 00B 00A 00B I00 I00 I00 I00 I00 I00 I00 I00 I00 I00 I00 I00 I00 I00 I00 I00 I00 I00 I00 I00 I00 I00 I00 I00 I00 I00 I00 I00 I00 I00 I00 I00 I00 I00 I00 I00 I00 I00 I00 I00 I00 I00 I00 I00 I00 I00 I00 I00 I00 I00 I00 I00 I00 I00 I00 I00 I00 I00 I00 I00 I00 I00 I00 I00 I00 I00 I00 I00 I00 I00 I00 I00 I00 I00 I00 I00 I00 I00 I00 I00 I00 I00 I00 I00 I00 I00 I00 I00 I00 I00 I00 I00 I00 I00 I00 I00 I00 I00 I00 I00 I00 I00 I00 I00 I00 I00 T02 T03 T04 I00 I00 T02 T03 T04 I00 I00 T02 T03
00C 00D 00C 00D 00C 00D 00C I00 I00 I00 I00 I00 I00 I00 I00 I00 I00 I00 I00 I00 I00 I00 I00 I00 I00 I00 I00 I00 I00 I00 I00 I00 I00 I00 I00 I00 I00 I00 I00 I00 I00 I00 I00 I00 I00 I00 I00 I00 I00 I00 I00 I00 I00 I00 I00 I00 I00 I00 I00 I00 I00 I00 I00 I00 I00 I00 I00 I00 I00 I00 I00 I00 I00 I00 I00 I00 I00 I00 I00 I00 I00 I00 I00 I00 I00 I00 I00 I00 I00 I00 I00 I00 I00 I00 I00 I00 I00 I00 I00 I00 I00 I00 I00 I00 I00 I00 I00 I00 I00 I00 I00 I00 I00 T02 T03 T04 I00 I00 T02 T03 T04 I00 I00 T02 T03
00B 00A 00B 00A 00B 00A 00B I00 I00 I00 I00 I00 I00 I00 I00 I00 I00 I00 I00 I00 I00 I00 I00 I00 I00 I00 I00 I00 I00 I00 I00 I00 I00 I00 I00 I00 I00 I00 I00 I00 I00 I00 I00 I00 I00 I00 I00 I00 I00 I00 I00 I00 I00 I00 I00 I00 I00 I00 I00 I00 I00 I00 I00 I00 I00 I00 I00 I00 I00 I00 I00 I00 I00 I00 I00 I00 I00 I00 I00 I00 I00 I00 I00 I00 I00 I00 I00 I00 I00 I00 I00 I00 I00 I00 I00 I00 I00 I00 I00 I00 I00 I00 I00 I00 I00 I00 I00 I00 I00 I00 I00 I00 I00 T02 T03 T04 I00 I00 T02 T03 T04 I00 I00 T02 T03
00C 00D 00C 00D 00C 00D 00C 002 002 002 I00 I00 I00 I00 I00 I00 I00 I00 I00 I00 I00 I00 I00 I00 I00 I00 I00 I00 I00 I00 I00 I00 I00 I00 I00 I00 I00 I00 I00 I00 I00 I00 I00 I00 I00 I00 I00 I00 I00 I00 I00 I00 I00 I00 I00 I00 I00 I00 I00 I00 I00 I00 I00 I00 I00 I00 I00 I00 I00 I00 I00 I00 I00 I00 I00 I00 I00 I00 I00 I00 I00 I00 I00 I00 I00 I00 I00 I00 I00 I00 I00 I00 I00 I00 I00 I00 I00 I00 I00 I00 I00 I00 I00 I00 I00 I00 I00 I00 I00 I00 I00 I00 I00 T02 T03 T04 I00 I00 T02 T03 T04 I00 I00 T02 T03
00B 00A 00B 00A 00B 00A 00B 00A 00B 002 I00 I00 I00 I00 I00 I00 I00 I00 I00 I00 I00 I00 I00 I00 I00 I00 I00 I00 I00 I00 I00 I00 I00 I00 I00 I00 I00 I00 I00 I00 I00 I00 I00 I00 I00 I00 I00 I00 I00 I00 I00 I00 I00 I00 I00 I00 I00 I00 I00 I00 I00 I00 I00 I00 I00 I00 I00 I00 I00 I00 I00 I00 I00 I00 I00 I00 I00 002 I00 I00 I00 I00 I00 I00 I00 I00 I00 I00 I00 I00 I00 I00 I00 I00 I00 I00 I00 I00 I00 I00 I00 I00 I00 I00 I00 I00 I00 I00 I00 I00 I00 I00 I00 T02 T03 T04 I00 I00 T02 T03 T04 I00 I00 T02 T03
00C 00D 00C 00D 00C 00D 00C 00D 00C 002 002 002 I00 I00 I00 I00 I00 I00 002 I00 I00 I00 I00 I00 I00 I00 I00 I00 I00 I00 0T0 I00 I00 I00 I00 I00 I00 I00 I00 002 I00 I00 I00 I00 I00 I00 I00 I00 I00 I00 I00 I00 I00 I00 I00 0T0 I00 I00 I00 I00 I00 I00 I00 I00 I00 I00 I00 I00 I00 I00 I00 I00 I00 I00 I00 I00 002 002 002 I00 I00 I00 I00 I00 I00 I00 I00 I00 I00 I00 I00 002 I00 I00 I00 I00 I00 I00 I00 I00 I00 I00 I00 I00 I00 I00 I00 I00 I00 I00 I00 I00 I00 T02 T03 T04 I00 I00 T02 T03 T04 I00 I00 T02 T03
00B 00A 00B 00A 00B 00A 00B 00A 00B 00A 00B 002 I00 I00 I00 I00 I00 002 002 002 I00 I00 I00 I00 I00 I00 I00 I00 I00 0T2 0T2 0T2 I00 I00 I00 I00 I00 I00 002 002 002 I00 I00 I00 I00 I00 I00 I00 I00 I00 I00 I00 I00 I00 0T2 0T2 0T2 I00 I00 I00 I00 I00 I00 I00 I00 I00 I00 I00 I00 I00 I00 I00 I00 I00 I00 002 002 002 002 002 I00 I00 I00 I00 I00 I00 I00 I00 I00 I00 002 002 002 I00 I00 I00 I00 I00 I00 I00 I00 I00 I00 I00 I00 I00 I00 I00 I00 I00 I00 I00 I00 T02 T03 T04 I00 I00 T02 T03 T04 I00 I00 T02 T03
00C 00D 00C 00D 00C 00D 00C 00D 00C 00D 00C 002 I00 I00 I00 I00 002 002 002 002 002 I00 I00 I00 I00 I00 I00 I00 0T0 0T1 0T1 0T1 0T0 I00 I00 I00 I00 002 002 002 002 002 I00 I00 I00 I00 I00 I00 I00 I00 I00 I00 I00 0T0 0T1 0T1 0T1 0T0 I00 I00 I00 I00 I00 I00 I00 I00 I00 I00 I00 I00 I00 I00 I00 I00 002 002 002 002 002 002 002 I00 I00 I00 I00 I00 I00 I00 I00 002 002 002 002 002 I00 I00 I00 I00 I00 I00 002 I00 I00 I00 I00 I00 I00 I00 I00 I00 I00 END T00 T01 T03 T05 T06 T00 T01 T03 T05 T06 T00 T01 T03 
001 001 001 001 001 001 001 001 001 001 001 001 001 001 001 001 001 001 001 001 001 001 001 001 001 001 001 001 001 001 001 001 001 001 001 001 001 001 001 001 001 001 001 001 001 001 001 001 001 001 001 001 001 001 001 001 001 001 001 001 001 001 001 001 001 001 001 001 001 001 001 001 001 001 001 001 001 001 001 001 001 001 001 001 001 001 001 001 001 001 001 001 001 001 001 001 001 001 001 001 001 001 001 001 001 001 001 001 001 001 001 001 001 001 001 001 001 001 001 001 001 001 001 001 001
000 000 000 000 000 000 000 000 000 000 000 000 000 000 000 000 000 000 000 000 000 000 000 000 000 000 000 000 000 000 000 000 000 000 000 000 000 000 000 000 000 000 000 000 000 000 000 000 000 000 000 000 000 000 000 000 000 000 000 000 000 000 000 000 000 000 000 000 000 000 000 000 000 000 000 000 000 000 000 000 000 000 000 000 000 000 000 000 000 000 000 000 000 000 000 000 000 000 000 000 000 000 000 000 000 000 000 000 000 000 000 000 000 000 000 000 000 000 000 000 000 000 000 000 000