I00 I00 I00 I00 I00 I00 I00 I00 I00 I00 I00 I00 I00 I00 I00 I00 I00 I00 I00 I00 I00 I00 I00 I00 I00 I00 I00 I00 I00 I00 I00 I00 I00 I00 I00 I00 I00 I00 I00 I00 I00 I00 I00 I00 I00 I00 I00 I00 I00 I00 I00 I00 I00 I00 I00 I00 I00 I00 I00 I00 I00 I00 I00 I00 I00 I00 I00 I00 I00 I00 I00 I00 I00 I00 I00 I00 I00 I00 I00 I00 I00 I00 I00 I00 I00 I00 I00 I00 I00 I00 I00 I00 I00 I00 I00 I00 I00 I00 I00 I00 I00 I00 I00 I00 I00 I00 I00 I00 I00 I00 I00 I00 I00 I00 I00 I00 I00 I00 I00 I00 I00 I00 I00 I00 I00
I00 I00 I00 I00 I00 I00 I00 I00 I00 I00 I00 I00 I00 I00 I00 I00 I00 I00 I00 I00 I00 I00 I00 I00 I00 I00 I00 I00 I00 I00 I00 I00 I00 I00 I00 I00 I00 I00 I00 I00 I00 I00 I00 I00 I00 I00 I00 I00 I00 I00 I00 I00 I00 I00 I00 I00 I00 I00 I00 I00 I00 I00 I00 I00 I00 I00 I00 I00 I00 I00 I00 I00 I00 I00 I00 I00 I00 I00 I00 I00 I00 I00 I00 I00 I00 I00 I00 I00 I00 I00 I00 I00 I00 I00 I00 I00 I00 I00 I00 I00 I00 I00 I00 I00 I00 I00 I00 I00 I00 I00 I00 I00 I00 I00 I00 I00 I00 I00 I00 I00 I00 I00 I00 I00 I00
I00 I00 I00 I00 I00 I00 I00 I00 I00 I00 I00 I00 I00 I00 I00 I00 I00 I00 I00 I00 I00 I00 I00 I00 I00 I00 I00 I00 I00 I00 I00 I00 I00 I00 I00 I00 I00 I00 I00 I00 I00 I00 I00 I00 I00 I00 I00 I00 I00 I00 I00 I00 I00 I00 I00 I00 I00 I00 I00 I00 I00 I00 I00 I00 I00 I00 I00 I00 I00 I00 I00 I00 I00 I00 I00 I00 I00 I00 I00 I00 I00 I00 I00 I00 I00 I00 I00 I00 I00 I00 I00 I00 I00 I00 I00 I00 I00 I00 I00 I00 I00 I00 I00 I00 I00 I00 I00 I00 I00 I00 I00 I00 I00 I00 I00 I00 I00 I00 I00 I00 I00 I00 I00 I00 I00
I00 I00 I00 I00 I00 I00 I00 I00 I00 I00 I00 I00 I00 I00 I00 I00 I00 I00 I00 I00 I00 I00 I00 I00 I00 I00 I00 I00 I00 I00 I00 I00 I00 I00 I00 I00 I00 I00 I00 I00 I00 I00 I00 I00 I00 I00 I00 I00 I00 I00 I00 I00 I00 I00 I00 I00 I00 I00 I00 I00 I00 I00 I00 I00 I00 I00 I00 I00 I00 I00 I00 I00 I00 I00 I00 I00 I00 I00 I00 I00 I00 I00 I00 I00 I00 I00 I00 I00 I00 I00 I00 I00 I00 I00 I00 I00 I00 I00 I00 I00 I00 I00 I00 I00 I00 I00 I00 I00 I00 I00 I00 I00 I00 I00 I00 I00 I00 I00 I00 I00 I00 I00 I00 I00 I00
I00 I00 I00 I00 I00 I00 I00 I00 I00 I00 I00 I00 I00 I00 I00 I00 I00 I00 I00 I00 I00 I00 I00 I00 I00 I00 I00 I00 I00 I00 I00 I00 I00 I00 I00 I00 I00 I00 I00 I00 I00 I00 I00 I00 I00 I00 I00 I00 I00 I00 I00 I00 I00 I00 I00 I00 I00 I00 I00 I00 I00 I00 I00 I00 I00 I00 I00 I00 I00 I00 I00 I00 I00 I00 I00 I00 I00 I00 I00 I00 I00 I00 I00 I00 I00 I00 I00 I00 I00 I00 I00 I00 I00 I00 I00 I00 I00 I00 I00 I00 I00 I00 I00 I00 I00 I00 I00 I00 I00 I00 I00 I00 I00 I00 I00 I00 I00 I00 I00 I00 I00 I00 I00 I00 I00
I00 I00 I00 I00 I00 I00 I00 I00 I00 I00 I00 I00 I00 I00 I00 I00 I00 I00 I00 I00 I00 I00 I00 I00 I00 I00 I00 I00 I00 I00 I00 I00 I00 I00 I00 I00 I00 I00 I00 I00 I00 I00 I00 I00 I00 I00 I00 I00 I00 I00 I00 I00 I00 I00 I00 I00 I00 I00 I00 I00 I00 I00 I00 I00 I00 I00 I00 I00 I00 I00 I00 I00 I00 I00 I00 I00 I00 I00 I00 I00 I00 I00 I00 I00 I00 I00 I00 I00 I00 I00 I00 I00 I00 I00 I00 I00 I00 I00 I00 I00 I00 I00 I00 I00 I00 I00 I00 I00 I00 I00 I00 I00 I00 I00 I00 I00 I00 I00 I00 I00 I00 I00 I00 I00 I00
I00 I00 I00 I00 I00 I00 I00 I00 I00 I00 I00 I00 I00 I00 I00 I00 I00 I00 I00 I00 I00 I00 I00 I00 I00 I00 I00 I00 I00 I00 I00 I00 I00 I00 I00 I00 I00 I00 I00 I00 I00 I00 I00 I00 I00 I00 I00 I00 I00 I00 I00 I00 I00 I00 I00 I00 I00 I00 I00 I00 I00 I00 I00 I00 I00 I00 I00 I00 I00 I00 I00 I00 I00 I00 I00 I00 I00 I00 I00 I00 I00 I00 I00 I00 I00 I00 I00 I00 I00 I00 I00 I00 I00 I00 I00 I00 I00 I00 I00 I00 I00 I00 I00 I00 I00 I00 I00 I00 I00 I00 I00 I00 I00 I00 I00 I00 I00 I00 I00 I00 I00 I00 I00 I00 I00
I00 I00 I00 I00 I00 I00 I00 I00 I00 I00 I00 I00 I00 I00 I00 I00 I00 I00 I00 I00 I00 I00 I00 I00 I00 I00 I00 I00 I00 I00 I00 I00 I00 I00 I00 I00 I00 I00 I00 I00 I00 I00 I00 I00 I00 I00 I00 I00 I00 I00 I00 I00 I00 I00 I00 I00 I00 I00 I00 I00 I00 I00 I00 I00 I00 I00 I00 I00 I00 I00 I00 I00 I00 I00 I00 I00 I00 I00 I00 I00 I00 I00 I00 I00 I00 I00 I00 I00 I00 I00 I00 I00 I00 I00 I00 I00 I00 I00 I00 I00 I00 I00 I00 I00 I00 I00 I00 I00 I00 I00 I00 I00 I00 I00 I00 I00 I00 I00 I00 I00 I00 I00 I00 I00 I00
I00 I00 I00 I00 I00 I00 I00 I00 I00 I00 I00 I00 I00 I00 I00 I00 I00 I00 I00 I00 I00 I00 I00 I00 I00 I00 I00 I00 I00 I00 I00 I00 I00 I00 I00 I00 I00 I00 I00 I00 I00 I00 I00 I00 I00 I00 I00 I00 I00 I00 I00 I00 I00 I00 I00 I00 I00 I00 I00 I00 I00 I00 I00 I00 I00 I00 I00 I00 I00 I00 I00 I00 I00 I00 I00 I00 I00 I00 I00 I00 I00 I00 I00 I00 I00 I00 I00 I00 I00 I00 I00 I00 I00 I00 I00 I00 I00 I00 I00 I00 I00 I00 I00 I00 I00 I00 I00 I00 I00 I00 I00 I00 I00 I00 I00 I00 I00 I00 I00 I00 I00 I00 I00 I00 I00
I00 I00 I00 I00 I00 I00 I00 I00 I00 I00 I00 I00 I00 I00 I00 I00 I00 I00 I00 I00 I00 I00 I00 I00 I00 I00 I00 I00 I00 I00 I00 I00 I00 I00 I00 I00 I00 I00 I00 I00 I00 I00 I00 I00 I00 I00 I00 I00 I00 I00 I00 I00 I00 I00 I00 I00 I00 I00 I00 I00 I00 I00 I00 I00 I00 I00 I00 I00 I00 I00 I00 I00 I00 I00 I00 I00 I00 I00 I00 I00 I00 I00 I00 I00 I00 I00 I00 I00 I00 I00 I00 I00 I00 I00 I00 I00 I00 I00 I00 I00 I00 I00 I00 I00 I00 I00 I00 I00 I00 I00 I00 I00 I00 I00 I00 I00 I00 I00 I00 I00 I00 I00 I00 I00 I00
I00 I00 I00 I00 I00 I00 I00 I00 I00 I00 I00 I00 I00 I00 I00 I00 I00 I00 I00 I00 I00 I00 I00 I00 I00 I00 I00 I00 I00 I00 I00 I00 I00 I00 I00 I00 I00 I00 I00 I00 I00 I00 I00 I00 I00 I00 I00 I00 I00 I00 I00 I00 I00 I00 I00 I00 I00 I00 I00 I00 I00 I00 I00 I00 I00 I00 I00 I00 I00 I00 I00 I00 I00 A01 I00 I00 I00 I00 I00 I00 I00 I00 I00 I00 I00 I00 I00 I00 I00 I00 I00 I00 I00 I00 I00 I00 I00 I00 I00 I00 I00 I00 I00 I00 I00 I00 I00 I00 I00 I00 I00 I00 I00 I00 I00 I00 I00 I00 I00 I00 I00 I00 I00 I00 I00
I00 I00 I00 I00 I00 I00 I00 I00 I00 I00 I00 I00 I00 I00 I00 I00 I00 I00 I00 I00 I00 I00 I00 I00 I00 I00 I00 I00 I00 I00 I00 I00 I00 I00 I00 I00 I00 I00 I00 I00 I00 I00 I00 I00 I00 I00 I00 I00 I00 I00 I00 I00 I00 I00 I00 I00 I00 I00 I00 I00 I00 I00 I00 I00 I00 I00 I00 I00 I00 I00 A01 I00 I00 I00 I00 I00 A01 I00 I00 I00 I00 I00 I00 I00 I00 I00 I00 I00 I00 I00 I00 I00 I00 I00 I00 I00 I00 I00 I00 I00 I00 I00 I00 I00 I00 I00 I00 I00 I00 I00 I00 I00 I00 I00 I00 I00 I00 I00 I00 I00 I00 I00 I00 I00 I00
I00 I00 I00 I00 I00 I00 I00 I00 I00 I00 I00 I00 I00 I00 I00 I00 I00 I00 I00 I00 I00 I00 I00 I00 I00 I00 I00 A01 I00 I00 I00 I00 I00 I00 A01 A01 I00 I00 I00 I00 I00 I00 I00 I00 I00 I00 I00 I00 I00 I00 I00 I00 I00 I00 I00 I00 I00 I00 I00 I00 I00 I00 I00 I00 I00 I00 I00 I00 I00 I00 I00 I00 I00 I00 I00 I00 I00 I00 I00 I00 I00 I00 I00 I00 I00 I00 I00 I00 I00 I00 I00 I00 I00 I00 I00 A01 I00 I00 I00 I00 I00 I00 I00 I00 I00 I00 I00 I00 I00 I00 I00 I00 I00 I00 I00 I00 I00 I00 I00 I00 I00 I00 I00 I00 I00
I00 I00 I00 I00 I00 I00 I00 I00 I00 I00 I00 I00 I00 I00 I00 I00 I00 I00 I00 I00 I00 I00 I00 I00 I00 I00 I00 I00 I00 I00 I00 I00 I00 I00 I00 I00 I00 I00 I00 I00 A01 I00 I00 I00 I00 I00 I00 A01 I00 I00 I00 I00 I00 I00 I00 I00 I00 I00 I00 I00 I00 I00 I00 I00 I00 I00 I00 I00 A01 I00 I00 I00 I00 I00 I00 I00 I00 I00 A01 I00 I00 I00 I00 I00 I00 I00 A01 I00 I00 I00 I00 I00 I00 I00 I00 I00 I00 I00 I00 I00 I00 I00 I00 I00 I00 I00 I00 I00 I00 I00 I00 I00 I00 I00 I00 I00 I00 I00 I00 I00 I00 I00 I00 I00 I00
I00 I00 I00 I00 I00 I00 I00 I00 I00 I00 I00 I00 I00 I00 I00 I00 I00 I00 I00 I00 I00 I00 I00 I00 I00 I00 I00 I00 I00 I00 I00 I00 I00 I00 I00 I00 I00 I00 I00 I00 I00 I00 I00 I00 I00 I00 I00 I00 I00 I00 I00 I00 I00 I00 I00 I00 I00 I00 I00 I00 I00 I00 I00 I00 I00 I00 I00 I00 I00 I00 I00 I00 I00 I00 I00 I00 I00 I00 I00 I00 I00 I00 I00 A01 I00 I00 I00 I00 I00 I00 A01 I00 I00 I00 I00 I00 I00 I00 I00 I00 I00 I00 I00 I00 I00 I00 I00 I00 I00 I00 I00 I00 I00 I00 I00 I00 I00 I00 I00 I00 I00 I00 I00 I00 I00
I00 I00 I00 I00 I00 I00 I00 I00 I00 I00 I00 I00 I00 I00 I00 I00 I00 I00 I00 I00 I00 I00 I00 I00 I00 I00 I00 I00 I00 I00 I00 A01 I00 I00 I00 I00 I00 I00 I00 I00 I00 I00 I00 I00 I00 I00 I00 I00 I00 A01 I00 A01 I00 I00 I00 A01 I00 A01 I00 A01 A01 I00 A01 I00 I00 I00 I00 I00 I00 I00 I00 I00 I00 I00 I00 I00 I00 I00 I00 I00 I00 I00 I00 I00 I00 I00 I00 I00 I00 I00 I00 I00 I00 I00 I00 I00 I00 I00 A01 I00 A01 I00 A01 I00 I00 A01 I00 A01 I00 I00 I00 I00 I00 I00 I00 I00 I00 I00 I00 I00 I00 I00 I00 I00 I00
I00 I00 I00 I00 I00 I00 I00 I00 I00 I00 I00 I00 I00 I00 I00 I00 I00 I00 I00 I00 I00 I00 I00 I00 I00 I00 I00 I00 I00 I00 I00 I00 I00 I00 I00 I00 I00 I00 I00 I00 I00 I00 I00 I00 I00 I00 I00 I00 I00 I00 I00 I00 I00 I00 I00 I00 I00 I00 I00 I00 I00 I00 I00 I00 I00 I00 I00 I00 I00 I00 I00 I00 I00 I00 I00 I00 I00 I00 I00 I00 I00 I00 I00 I00 I00 I00 I00 I00 I00 I00 I00 I00 I00 I00 I00 I00 I00 I00 I00 I00 I00 I00 I00 I00 I00 I00 I00 I00 I00 I00 I00 I00 I00 I00 I00 I00 I00 I00 I00 I00 I00 I00 I00 I00 I00
I00 I00 I00 I00 I00 I00 I00 I00 I00 I00 I00 I00 I00 I00 I00 I00 I00 I00 I00 I00 I00 I00 I00 I00 I00 I00 I00 I00 I00 I00 I00 I00 I00 I00 I00 I00 I00 I00 I00 I00 I00 I00 I00 I00 I00 I00 I00 I00 I00 I00 I00 I00 I00 I00 I00 I00 I00 I00 I00 I00 I00 I00 I00 I00 I00 I00 I00 I00 I00 I00 I00 I00 I00 I00 I00 I00 I00 I00 I00 I00 I00 I00 I00 I00 I00 I00 I00 I00 I00 I00 I00 I00 I00 I00 I00 I00 I00 I00 I00 I00 I00 I00 I00 I00 I00 I00 I00 I00 I00 I00 I00 I00 I00 I00 I00 I00 I00 I00 I00 I00 I00 I00 I00 I00 I00
