I00 I00 T02 T03 T04 I00 I00 T02 T03 T04 I00 I00 I00 I00 I00 I00 I00 I00 I00 I00 I00 I00 I00 I00 I00 I00 I00 I00 I00 I00 I00 I00 I00 I00 I00 I00 I00 I00 I00 I00 I00 I00 I00 I00 I00 I00 I00 I00 I00 I00 I00 I00 I00 I00 I00 I00 I00 I00 I00 I00 I00 I00 I00 I00 I00 I00 I00 I00 I00 I00 I00 I00 I00 I00 I00 I00 I00 I00 I00 I00 I00 I00 I00 I00 I00 I00 I00 I00 I00 I00 I00 I00 I00 I00 I00 I00 I00 I00 I00 I00 I00 I00 I00 I00 I00 I00 I00 I00 I00 I00 I00 I00 T02 T03 T04 I00 I00 T02 T03 T04 I00 I00 T02 T03 T04
I00 I00 T02 T03 T04 I00 I00 T02 T03 T04 I00 I00 I00 I00 I00 I00 I00 I00 I00 I00 I00 I00 I00 I00 I00 I00 I00 I00 I00 I00 I00 I00 I00 I00 I00 I00 I00 I00 I00 I00 I00 I00 I00 I00 I00 I00 I00 I00 I00 I00 I00 I00 I00 I00 I00 I00 I00 I00 I00 I00 I00 I00 I00 I00 I00 I00 I00 I00 I00 I00 I00 I00 I00 I00 I00 I00 I00 I00 I00 I00 I00 I00 I00 I00 I00 I00 I00 I00 I00 I00 I00 I00 I00 I00 I00 I00 I00 I00 I00 I00 I00 I00 I00 I00 I00 I00 I00 I00 I00 I00 I00 I00 T02 T03 T04 I00 I00 T02 T03 T04 I00 I00 T02 T03 T04
I00 I00 T02 T03 T04 I00 I00 T02 T03 T04 I00 I00 I00 I00 I00 I00 I00 I00 I00 I00 I00 I00 I00 I00 I00 I00 I00 I00 I00 I00 I00 I00 I00 I00 I00 I00 I00 I00 I00 I00 I00 I00 I00 I00 I00 I00 I00 I00 I00 I00 I00 I00 I00 I00 I00 I00 I00 I00 I00 I00 I00 I00 I00 I00 I00 I00 I00 I00 I00 I00 I00 I00 I00 I00 I00 I00 I00 I00 I00 I00 I00 I00 I00 I00 I00 I00 I00 I00 I00 I00 I00 I00 I00 I00 I00 I00 I00 I00 I00 I00 I00 I00 I00 I00 I00 I00 I00 I00 I00 I00 I00 I00 T02 T03 T04 I00 I00 T02 T03 T04 I00 I00 T02 T03 T04
I00 I00 T02 T03 T04 I00 I00 T02 T03 T04 I00 I00 I00 I00 I00 I00 I00 I00 I00 I00 I00 I00 I00 I00 I00 I00 I00 I00 I00 I00 I00 I00 I00 I00 I00 I00 I00 I00 I00 I00 I00 I00 I00 I00 I00 I00 I00 I00 I00 I00 I00 I00 I00 I00 I00 I00 I00 I00 I00 I00 I00 I00 I00 I00 I00 I00 I00 I00 I00 I00 I00 I00 I00 I00 I00 I00 I00 I00 I00 I00 I00 I00 I00 I00 I00 I00 I00 I00 I00 I00 I00 I00 I00 I00 I00 I00 I00 I00 I00 I00 I00 I00 I00 I00 I00 I00 I00 I00 I00 I00 I00 I00 T02 T03 T04 I00 I00 T02 T03 T04 I00 I00 T02 T03 T04
I00 I00 T02 T03 T04 I00 I00 T02 T03 T04 I00 I00 I00 I00 I00 I00 I00 I00 I00 I00 I00 I00 I00 I00 I00 I00 I00 I00 I00 I00 I00 I00 I00 I00 I00 I00 I00 I00 I00 I00 I00 I00 I00 I00 I00 I00 I00 I00 I00 I00 I00 I00 I00 I00 I00 I00 I00 I00 I00 I00 I00 I00 I00 I00 I00 I00 I00 I00 I00 I00 I00 I00 I00 I00 I00 I00 I00 I00 I00 I00 I00 I00 I00 I00 I00 I00 I00 I00 I00 I00 I00 I00 I00 I00 I00 I00 I00 I00 I00 I00 I00 I00 I00 I00 I00 I00 I00 I00 I00 I00 I00 I00 T02 T03 T04 I00 I00 T02 T03 T04 I00 I00 T02 T03 T04
I00 I00 T02 T03 T04 I00 I00 T02 T03 T04 I00 I00 I00 I00 I00 I00 I00 I00 I00 I00 I00 I00 I00 I00 I00 I00 I00 I00 I00 I00 I00 I00 I00 I00 I00 I00 I00 I00 I00 I00 I00 I00 I00 I00 I00 I00 I00 I00 I00 I00 I00 I00 I00 I00 I00 I00 I00 I00 I00 I00 I00 I00 I00 I00 I00 I00 I00 I00 I00 I00 I00 I00 I00 I00 I00 I00 I00 I00 I00 I00 I00 I00 I00 I00 I00 I00 I00 I00 I00 I00 I00 I00 I00 I00 I00 I00 I00 I00 I00 I00 I00 I00 I00 I00 I00 I00 I00 I00 I00 I00 I00 I00 T02 T03 T04 I00 I00 T02 T03 T04 I00 I00 T02 T03 T04
I00 I00 T02 T03 T04 I00 I00 T02 T03 T04 I00 I00 I00 I00 I00 I00 I00 I00 I00 I00 I00 I00 I00 I00 I00 I00 I00 I00 I00 I00 I00 I00 I00 I00 I00 I00 I00 I00 I00 I00 I00 I00 I00 I00 I00 I00 I00 I00 I00 I00 I00 I00 I00 I00 I00 I00 I00 I00 I00 I00 I00 I00 I00 I00 I00 I00 I00 I00 I00 I00 I00 I00 I00 I00 I00 I00 I00 I00 I00 I00 I00 I00 I00 I00 I00 I00 I00 I00 I00 I00 I00 I00 I00 I00 I00 I00 I00 I00 I00 I00 I00 I00 I00 I00 I00 I00 I00 I00 I00 I00 I00 I00 T02 T03 T04 I00 I00 T02 T03 T04 I00 I00 T02 T03 T04
I00 I00 T02 T03 T04 I00 I00 T02 T03 T04 I00 I00 I00 I00 I00 I00 I00 I00 I00 I00 I00 I00 I00 I00 I00 I00 I00 I00 I00 I00 I00 I00 I00 I00 I00 I00 I00 I00 I00 I00 I00 I00 I00 I00 I00 I00 I00 I00 I00 I00 I00 I00 I00 I00 I00 I00 I00 I00 I00 I00 I00 I00 I00 I00 I00 I00 I00 I00 I00 I00 I00 I00 I00 I00 I00 I00 I00 I00 I00 I00 I00 I00 I00 I00 I00 I00 I00 I00 I00 I00 I00 I00 I00 I00 I00 I00 I00 I00 I00 I00 I00 I00 I00 I00 I00 I00 I00 I00 I00 I00 I00 I00 T02 T03 T04 I00 I00 T02 T03 T04 I00 I00 T02 T03 T04
I00 I00 T02 T03 T04 I00 I00 T02 T03 T04 I00 I00 I00 I00 I00 I00 I00 I00 I00 I00 I00 I00 I00 I00 I00 I00 I00 I00 I00 I00 I00 I00 I00 I00 I00 I00 I00 I00 I00 I00 I00 I00 I00 I00 I00 I00 I00 I00 I00 I00 I00 I00 I00 I00 I00 I00 I00 I00 I00 I00 I00 I00 I00 I00 I00 I00 I00 I00 I00 I00 I00 I00 I00 I00 I00 I00 I00 I00 I00 I00 I00 I00 I00 I00 I00 I00 I00 I00 I00 I00 I00 I00 I00 I00 I00 I00 I00 I00 I00 I00 I00 I00 I00 I00 I00 I00 I00 I00 I00 I00 I00 I00 T02 T03 T04 I00 I00 T02 T03 T04 I00 I00 T02 T03 T04
I00 I00 T02 T03 T04 I00 I00 T02 T03 T04 I00 I00 I00 I00 I00 I00 I00 I00 I00 I00 I00 I00 I00 I00 I00 I00 I00 I00 I00 I00 I00 I00 I00 I00 I00 I00 I00 I00 I00 I00 I00 I00 I00 I00 I00 I00 I00 I00 I00 I00 I00 I00 I00 I00 I00 I00 I00 I00 I00 I00 I00 I00 I00 I00 I00 I00 I00 I00 I00 I00 I00 I00 I00 I00 I00 I00 I00 I00 I00 I00 I00 I00 I00 I00 I00 I00 I00 I00 I00 I00 I00 I00 I00 I00 I00 I00 I00 I00 I00 I00 I00 I00 I00 I00 I00 I00 I00 I00 I00 I00 I00 I00 T02 T03 T04 I00 I00 T02 T03 T04 I00 I00 T02 T03 T04
I00 I00 T02 T03 T04 I00 I00 T02 T03 T04 I00 I00 I00 I00 I00 I00 I00 I00 I00 I00 I00 I00 I00 I00 I00 I00 I00 I00 I00 I00 I00 I00 I00 I00 I00 I00 I00 I00 I00 I00 I00 I00 I00 I00 I00 I00 I00 I00 I00 I00 I00 I00 I00 I00 I00 I00 I00 I00 I00 I00 I00 I00 I00 I00 I00 I00 I00 I00 I00 I00 I00 I00 I00 BK2 I00 I00 I00 I00 I00 I00 I00 I00 I00 I00 I00 I00 I00 I00 I00 I00 I00 I00 I00 I00 I00 I00 I00 I00 I00 I00 I00 I00 I00 I00 I00 I00 I00 I00 I00 I00 I00 I00 T02 T03 T04 I00 I00 T02 T03 T04 I00 I00 T02 T03 T04
I00 I00 T02 T03 T04 I00 I00 T02 T03 T04 I00 I00 I00 I00 I00 I00 I00 I00 I00 I00 I00 I00 I00 I00 I00 I00 I00 I00 I00 I00 I00 I00 I00 I00 I00 I00 I00 I00 I00 I00 I00 I00 I00 I00 I00 I00 I00 I00 I00 I00 I00 I00 I00 I00 I00 I00 I00 I00 I00 I00 I00 I00 I00 I00 I00 I00 I00 I00 I00 I00 I00 I00 BK2 BK1 BK2 I00 I00 I00 I00 I00 I00 I00 I00 I00 I00 I00 I00 I00 I00 I00 I00 I00 I00 I00 I00 I00 I00 I00 I00 I00 I00 I00 I00 I00 I00 I00 I00 I00 I00 I00 I00 I00 T02 T03 T04 I00 I00 T02 T03 T04 I00 I00 T02 T03 T04
I00 I00 T02 T03 T04 I00 I00 T02 T03 T04 I00 I00 I00 I00 I00 I00 I00 I00 I00 I00 I00 I00 I00 I00 I00 I00 I00 I00 I00 I00 I00 I00 I00 I00 I00 I00 I00 I00 I00 I00 I00 I00 I00 BK1 BK2 I00 I00 I00 I00 I00 I00 I00 I00 I00 I00 I00 I00 I00 I00 I00 I00 I00 I00 I00 I00 I00 I00 I00 I00 I00 I00 BK2 BK1 BK2 BK1 BK2 I00 I00 I00 I00 I00 I00 I00 I00 I00 I00 I00 I00 I00 I00 I00 I00 I00 I00 I00 I00 I00 I00 I00 I00 I00 I00 I00 I00 I00 I00 I00 I00 I00 I00 I00 I00 T02 T03 T04 I00 I00 T02 T03 T04 I00 I00 T02 T03 T04
I00 I00 T02 T03 T04 I00 I00 T02 T03 T04 I00 I00 I00 I00 I00 I00 I00 I00 I00 I00 I00 I00 I00 I00 I00 I00 I00 I00 I00 I00 I00 I00 I00 I00 I00 I00 I00 I00 I00 I00 I00 I00 BK1 BK2 BK1 BK2 I00 I00 I00 I00 I00 I00 I00 I00 I00 I00 I00 I00 I00 I00 I00 I00 I00 I00 I00 I00 I00 I00 I00 I00 BK2 BK1 BK2 BK1 BK2 BK1 BK2 I00 I00 I00 I00 I00 I00 I00 I00 I00 I00 I00 I00 I00 I00 I00 I00 I00 I00 I00 I00 I00 I00 I00 I00 I00 I00 I00 I00 I00 I00 I00 I00 I00 I00 I00 T02 T03 T04 I00 I00 T02 T03 T04 I00 I00 T02 T03 T04
I00 I00 T02 T03 T04 I00 I00 T02 T03 T04 I00 I00 I00 I00 I00 I00 I00 I00 I00 I00 I00 I00 I00 I00 I00 I00 I00 BK1 I00 I00 I00 I00 I00 I00 0T2 0T2 I00 I00 I00 I00 I00 BK1 BK2 BK1 BK2 BK1 BK2 I00 I00 I00 I00 I00 I00 I00 I00 I00 BK1 I00 BK1 I00 I00 BK2 I00 I00 I00 I00 I00 I00 I00 BK2 BK1 BK2 BK1 BK2 BK1 BK2 BK1 BK2 I00 I00 I00 I00 I00 I00 I00 I00 I00 I00 I00 I00 I00 I00 I00 I00 I00 I00 I00 I00 I00 I00 I00 I00 I00 I00 I00 I00 I00 I00 I00 I00 I00 I00 T02 T03 T04 I00 I00 T02 T03 T04 I00 I00 T02 T03 T04
T06 T00 T01 T03 T05 T06 T00 T01 T03 T05 T06 I00 I00 I00 I00 I00 I00 I00 I00 I00 I00 I00 I00 I00 I00 I00 BK1 BK2 BK1 I00 I00 I00 I00 0T0 0T1 0T1 0T0 I00 I00 I00 BK1 BK2 BK1 BK2 BK1 BK2 BK1 BK2 I00 I00 I00 I00 I00 I00 I00 BK1 BK2 BK1 BK2 BK1 BK2 BK1 BK2 I00 I00 I00 I00 I00 BK2 BK1 BK2 BK1 BK2 BK1 BK2 BK1 BK2 BK1 BK2 I00 I00 I00 I00 I00 I00 I00 BK1 I00 I00 I00 I00 I00 I00 I00 I00 BK2 I00 I00 I00 I00 I00 I00 I00 I00 I00 I00 I00 I00 I00 I00 END T00 T01 T03 T05 T06 T00 T01 T03 T05 T06 T00 T01 T03 T05
001 001 001 001 001 001 001 001 001 001 001 001 001 001 001 001 001 001 001 001 001 001 001 001 001 001 001 001 001 001 001 001 001 001 001 001 001 001 001 001 001 001 001 001 001 001 001 001 001 001 001 001 001 001 001 001 001 001 001 001 001 001 001 001 001 001 001 001 001 001 001 001 001 001 001 001 001 001 001 001 001 001 001 001 001 001 001 001 001 001 001 001 001 001 001 001 001 001 001 001 001 001 001 001 001 001 001 001 001 001 001 001 001 001 001 001 001 001 001 001 001 001 001 001 001
000 000 000 000 000 000 000 000 000 000 000 000 000 000 000 000 000 000 000 000 000 000 000 000 000 000 000 000 000 000 000 000 000 000 000 000 000 000 000 000 000 000 000 000 000 000 000 000 000 000 000 000 000 000 000 000 000 000 000 000 000 000 000 000 000 000 000 000 000 000 000 000 000 000 000 000 000 000 000 000 000 000 000 000 000 000 000 000 000 000 000 000 000 000 000 000 000 000 000 000 000 000 000 000 000 000 000 000 000 000 000 000 000 000 000 000 000 000 000 000 000 000 000 000 000